MWAllMacros=所有宏
MWAllActions=所有动作
MWFavoritesActions=收藏夹

kmDeleteButton=删除
kmCancelButton=取消
kmOKButton=好
kmTryButton=尝试
kmTryNButton=尝试%d动作
kmViewButton=视图
kmMoveButton=移动
kmSaveButton=保存
kmRestoreButton=移动

kmEnableContextualMenu=启用
kmDisableContextualMenu=关闭
kmEnableNContextualMenu=启用%d动作
kmDisableNContextualMenu=禁用%d动作

ACProcessControl=应用控制
ACInterfaceControl=接口控制
ACiTunesControl=iTunes控制
ACQuickTimePlayerControl=QuickTime播放器控制
ACMailControl=邮件控制
ACWebBrowserControl=%@控制
ACSystemControl=系统控制
ACMIDI=MIDI
ACOpen=打开
ACExecute=执行
ACWeb=Web
ACFile=文件
ACImage=图片
ACText=文本
ACClipboard=剪贴板
ACVariables=变量
ACActivateSwitcher=切换器
ACNotifications=通知
ACControlFlow=控制流
ACKeyboardMaestro=Keyboard Maestro
ACDebugger=调试器
ACPlugIns=第三方插件

ACClipboardCut=剪切
ACClipboardCopy=复制
ACClipboardPaste=粘贴

ACClipboardToVariable=设置剪贴板到变量
ACVariableToClipboard=设置变量到剪贴板
ACSetKeychainPasswordToVariable=设置钥匙串密码到变量

ACDeleteCurrentClipboard=删除当前剪贴板

csBrowserHelpFlavorTypesPrefix=剪贴板内容类型：
csBrowserHelpTextPreviewPrefix=文本预览：\r\r

csCopyActionMessage=复制到已命名剪贴板：
csCutActionMessage=剪切到已命名剪贴板：
csPasteActionMessage=从已命名剪贴板粘贴：

csHistoryActionMessage=从剪贴板历史粘贴：
NonTextClipboardMD5Format=非文本剪贴板%@

csInsertNewClipDataItem=<新建命名剪贴板>
csNewClipboardTitleFormat=剪贴板＃%d
csNewClipboardDefaultData=默认剪贴板文本
DefaultClipboardName=默认剪贴板

csNoClipboardsAvailable=没有剪贴板可用

ClipboardHistorySwitcherPasteWindowTitle=剪贴板历史记录切换器
ClipboardNamedSwitcherCutWindowTitle=已命名剪贴板切换器 - 剪切
ClipboardNamedSwitcherCopyWindowTitle=已命名剪贴板切换器 - 复制
ClipboardNamedSwitcherPasteWindowTitle=剪贴板切换器 - 粘贴

ReceivedClipboard=收到剪贴板
SentClipboard=发送剪贴板
SentClipboardAbandonded=剪贴板发送失败（太多重试）

PreferencesWindowTitle=首选项：%@
IconChooserWindowTitle=图标选配：%@

NoClipboardText=剪贴板没有文本

wsWindowSwitchNoWindowsString=没有可用的窗口
wsWindowSwitchNoAXAString=残疾人无障碍

psProgramSwitchNoProgramsString=没有可用的应用程序

kmKeystrokeBadErrorStr=击键不能使用。
ManualSIVCNoNewVersionTitle=Keyboard Maestro是最新的。
ManualSIVCNoNewVersionStr=您正在运行最新的版本。
ManualSIVCErrorTitle=版本检查失败。
ManualSIVCErrorStr=试图检查键盘大师的当前版本时出现错误。
SIVCTitle=Keyboard Maestro更新
SIVCHeading=Keyboard Maestro新版本已可用。
InstallFailedTitle=自动安装失败。
MacroGroupAvailableHTML_All=在所有应用程序中可用。
MacroGroupAvailableHTML_Active=在这些应用程序中可用：
MacroGroupAvailableHTML_NotActive=<strong>除</strong>这些应用程序外可用：
MacroGroupAvailableHTML_Running=这些应用程序<strong>任一</strong>运行时可用：
MacroGroupAvailableHTML_RunningNotActive=在且仅在这些应用程序任一运行时可用：
MacroGroupAvailableHTML_NotRunning=这些应用程序<strong>无一</strong>运行时可用：
MacroGroupActivationNormal=始终激活。
MacroGroupActivationOnceAfterTrigger=为一个动作激活，当：
MacroGroupActivationToggleWithTrigger=激活/停用，当：
MacroGroupActivationOnceWithPalette=为一个动作显示悬浮窗，当：
MacroGroupActivationWithPalette=显示/隐藏悬浮窗，当：
MacroGroupActivationAlwaysWithPalette=显示一个悬浮窗，直到：
MacroGroupActivationNormalUnderMouse=始终激活。
MacroGroupActivationOnceAfterTriggerUnderMouse=为一个动作激活，当：
MacroGroupActivationToggleWithTriggerUnderMouse=激活/停用，当：
MacroGroupActivationOnceWithPaletteUnderMouse=为一个动作在鼠标下方显示悬浮窗，当：
MacroGroupActivationWithPaletteUnderMouse=在鼠标下方显示/隐藏悬浮窗，当：
MacroGroupActivationAlwaysWithPaletteUnderMouse=在鼠标下方显示一个悬浮窗，直到：
kRevisions0000_01_01=版本7之前
kRevisions9999_01_01=在编辑器启动时
kRevisions9999_01_02=最后还原前
kRevisions9999_01_03=上次同步前
EnterUniCharLong=输入
DeleteUniCharLong=删除
EscapeUniCharLong=退出
ClearUniCharLong=清除
DeleteRightUniCharLong=向前删除
ReturnUniCharLong=回车
SpaceUniCharShort=空格
SpaceUniCharLong=空格
PageUpUniCharLong=向上翻页
PageDownUniCharLong=向下翻页
HelpUniCharLong=帮助/插入
HomeUniCharLong=主页
EndUniCharLong=结尾
LeftArrowUniCharLong=左箭头
RightArrowUniCharLong=右箭头
DownArrowUniCharLong=下箭头
UpArrowUniCharLong=上箭头
NoPreferencePanesAvailable =无首选项窗格可用

NumberPadSubmenu =小键盘
FunctionKeySubmenu =功能键

UnknownFileOrFolderName =未知
kHardwareKey_SOUND_UP=提高音量
kHardwareKey_SOUND_DOWN=降低音量
kHardwareKey_BRIGHTNESS_UP=提高亮度
kHardwareKey_BRIGHTNESS_DOWN=降低亮度
kHardwareKey_CAPS_LOCK=大写锁定
kHardwareKey_HELP=帮助
kHardwareKey_POWER_KEY=电源键
kHardwareKey_MUTE=静音
kHardwareKey_NUM_LOCK=键盘锁
kHardwareKey_CONTRAST_UP=提高对比度
kHardwareKey_CONTRAST_DOWN=降低对比度
kHardwareKey_LAUNCH_PANEL=启动面板
kHardwareKey_EJECT=弹出
kHardwareKey_VIDMIRROR=视频镜像
kHardwareKey_PLAY=播放
kHardwareKey_NEXT=下一个
kHardwareKey_PREVIOUS=上一个
kHardwareKey_FAST=快进
kHardwareKey_REWIND=快退
kHardwareKey_ILLUMINATION_UP=提升
kHardwareKey_ILLUMINATION_DOWN=提高背光灯亮度
kHardwareKey_ILLUMINATION_TOGGLE=降低背光灯亮度
UnnamedUsername=未命名

NoTrigger=无

RecordingLabel=录制
EnabledButton=已启用
EnabledToolTip=已启用
DisabledButton=已禁用
DisabledToolTip=已禁用

OtherHotKeyMenu=其他…
TypeHotKey=按键
ClickHotKey=键击

TypeHIDKey=按下并释放
TryAgainHIDKey=再试一次
ClickHIDKey=点击

HideActionsMenu=隐藏动作
ShowActionsMenu=显示动作
cLocationTitle=位置条件

cLocation_LongDescription_Is=网络位置是‘%@’
cLocation_LongDescription_IsNot=网络位置不是‘%@’
cLocation_LongDescription_Contains=网络位置包含‘%@’
cLocation_LongDescription_DoesNotContain=网络位置不包含‘%@’
cLocation_LongDescription_Matches=网络位置匹配‘%@’
cLocation_LongDescription_DoesNotMatch=网络位置不匹配‘%@’

cScriptTitle=脚本条件

cScript_LongDescription_ReturnsSuccess=脚本返回成功
cScript_LongDescription_ReturnsError=脚本返回一个错误
cScript_LongDescription_ReturnsStatus=脚本返回状态是%d
cScript_LongDescription_Is=脚本结果是‘%@’
cScript_LongDescription_IsNot=脚本结果不是‘%@’
cScript_LongDescription_Contains=脚本结果包含‘%@’
cScript_LongDescription_DoesNotContain=脚本结果不包含‘%@’
cScript_LongDescription_Matches=脚本结果匹配‘%@’
cScript_LongDescription_DoesNotMatch=脚本结果不匹配‘%@’
hkSwitchToLastApplication=激活上一个应用程序
hkSwitchToNextApplication=激活下一个应用程序
hkBringWindowsForward=前置应用程序窗口
hkSearch=搜索网页
hkTriggerByName=通过名称触发宏
hkOpen1File=打开一个文件，文件夹或应用程序
hkFile=移动，复制或把文件移到废纸篓
hkReadFile=读取文件
hkWriteFile=写入或追加文件
hkWriteFileWrite=写入文件
hkWriteFileAppend=追加文本文件
hkNewFolder=新建文件夹
hkPlugIn=插入
hkGetFileAttribute=获取文件属性
hkSetFileAttribute=设置文件属性
hkOpenFinderSelection=打开Finder选择
hkOpenURL=打开网址
hkActivateApplication=激活特定应用程序
hkQuitOthers=退出其他应用程序
hkQuitAll=退出所有应用程序
hkQuitSpecificApp=退出特定应用程序
hkQuitCurrentApp=退出前台应用程序
hkHideOthers=隐藏其他应用程序
hkHideAll=隐藏所有应用程序
hkHideCurrent=隐藏前台应用程序
hkHideSpecificApp=隐藏特定应用程序
hkShowAll=显示所有的应用程序
hkShowSpecificApp=显示特定应用程序
hkInsertText=插入文本
hkSetFindPasteboard=设置查找粘贴板
hkSetNetworkLocation=设置网络位置
hkFastUserSwitch=快速用户切换
hkSetKeyboardLayout=设置键盘布局
hkQuickMacro=录制快速宏
hkSimulateKeystroke=键入按键
hkSimulateModifiers=键入修饰键
hkSimulateHardwareKey=模拟硬件密钥
hkExecuteAppleScript=执行一个AppleScript
hkExecuteJavaScript=在Safari内执行一个JavaScript
hkExecuteShellScript=执行一个Shell脚本
hkExecuteJavaScriptForAutomation=执行一个JavaScript来自动化
hkExecuteSwift=执行一个Swift脚本
hkExecuteWorkflow=执行一个Automator工作流
hkExecuteMacro=执行宏
hkMarkMacro=标记宏
hkSetMacroEnable=设置宏或组为启用
hkSystemPrefPane=打开系统偏好设置面板
tHIDTriggerDescPressedFormat=%@键被按下
tHIDTriggerDescWhileDownFormat=当%@键被按下时
tHIDTriggerDescReleasedFormat=%@键被释放
tHIDTriggerDescTappedFormat=%@键被轻击
tHIDTriggerDescTappedOnceFormat=%@键被轻击一次
tHIDTriggerDescTappedTwiceFormat=%@键被轻击两次
tHIDTriggerDescTappedTimesFormat=%@键被轻击%d次
hkOpen1Password=打开1Password书签
hkMouseMoveAndClick=移动或点击鼠标
hkSpeakText=朗读文本
hkPlaySound=播放声音
hkSystemAction=执行系统操作
hkDebuggerAction=调试动作
hkSystemVolume=设置系统输出音量
hkSendMIDIMessage=发送MIDI信息
hkPause=暂停
hkPauseUntil=暂停，直到
hkWhile=当
hkUntil=直到
hkRepeat=重复
hkGroup=组合
hkIfThenElse=如果然后否则
hkSwitch=切换/情形
hkFor=对于每个
hkAlert=警报
hkComment=评论
hkCancel=取消宏
hkMacroGroupToggle=切换宏组
hkConcealMacroPalettes=隐藏宏悬浮窗
hkSelectMenuItem=选择或显示一个菜单项
hkiTunesControl=iTunes控制
hkQuickTimePlayerControl=QuickTime播放器控制
hkScrollWheelEvent=模拟滚轮
hkManipulateWindow=操作窗口
hkHiliteLocation=突出位置
hkScreenCapture=屏幕捕获
hkFindImage=发现屏幕上的影像
hkGrowl=Growl通知
hkLog=日志
hkNotification=通知
CancelAllMacros=取消所有宏
CancelAllOtherMacros=取消所有其他宏
CancelThisMacro=取消此宏
CancelJustThisMacro=只取消此宏
BreakFromLoop=打破循环

ConcealActionTitle=隐藏宏悬浮窗
RevealActionTitle=显示宏悬浮窗
ToggleActionTitle=隐藏/显示宏悬浮窗
ConcealUntilAppSwitchActionTitle=隐藏宏悬浮窗直到切换
ConcealUntilAppSwitchOrRevealActionTitle=隐藏/显示宏悬浮窗直到切换
kmOpenURLTitleFormat=打开网址：%@
hkPauseTitleFormat=暂停%@秒

hkPauseUntilTitle=暂停，直到满足条件：
kAlertDefaultTitle=Keyboard Maestro警报
kAlertDefaultText=你想继续执行还是现在停止？
hkAlertTitle=警报‘%@’
AlertContinueButton=继续
AlertStopButton=停止

kCommentDefaultTitle=无标题

hkCommentTitle=评论‘%@’

kGrowlDefaultTitle=无标题

hkGrowlTitle=Growl通知‘%@’

hkLogTitle=登录‘%@’
kmUntitledMacro=无标题宏
kmUntitledMacroFormat=无题宏%d
kmUntitledMacroRegEx=^无标题宏( \\d+)$
kmUntitledMacroGroup=无题宏组
kmUntitledMacroGroupFormat=无题宏组%d
kmUntitledMacroSmartGroup=无标题智能组
kmUntitledMacroSmartGroupFormat=无标题智能组%d
kmExecuteBaseScriptTitleFormat=执行‘%@’%@
kmExecuteBaseScriptTitle=执行%@

kmCustomPromptTitleFormat=自定义HTML提示‘%@’
kmCustomPromptTitle=自定义HTML提示

kmFindImageHTML=查找%@图像在屏幕上变‘%@’

kmExecuteBaseScriptResultsTitle=%@结果

kmExecuteRootScriptResultsDescription=%@的输出为：

kmExecuteBaseScriptFileFormatLongName=脚本‘%@’
kmExecuteBaseScriptTextLongName=文字脚本


ExecuteBaseScriptResultWindow=在一个窗口中显示%@。
ExecuteBaseScriptResultBriefly=短暂显示%@。
ExecuteBaseScriptResultLarge=大尺寸显示%@。
ExecuteBaseScriptResultTyping=键入%@。
ExecuteBaseScriptResultPasting=粘贴%@。
ExecuteBaseScriptResultVariable=保存%@到变量‘%%@’。
ExecuteBaseScriptResultClipboard=保存%@到%%@.
ExecuteBaseScriptResultAsynchronously=异步执行。
ExecuteBaseScriptResultTrim0StdErr0=结果没有错误
ExecuteBaseScriptResultTrim0StdErr1=结果
ExecuteBaseScriptResultTrim1StdErr0=修剪的结果没有错误
ExecuteBaseScriptResultTrim1StdErr1=修剪的结果

kmPlugInLongScriptName=插入动作‘%@’

kmExecuteWorkflowTitleFormat=执行‘%@’的Automator工作流

kmExecuteMacroTitleFormat=执行宏‘%@’
kmExecuteMacroAsynchronouslyTitleFormat=异步执行宏‘%@’

kmMarkMacroMarkTitleFormat=标记宏‘%@’
kmMarkMacroUnmarkTitleFormat=取消标记宏‘%@’
kmMarkMacroToggleTitleFormat=切换标记宏‘%@’

kmMarkUnknownMacroMarkTitleFormat=标记宏
kmMarkUnknownMacroUnmarkTitleFormat=取消标记宏
kmMarkUnknownMacroToggleTitleFormat=切换标记宏

NoMacroSelectionName=无
kmMouseTitleFormat=%@%@%@
kmMouseJustMoveTo=到
kmMouseClickAt=在
kmMouseTitleAtFormat=(%@,%@)相对于%@

kmMouseActionClick9Title=释放%@
kmMouseActionClick10Title=移动鼠标
kmMouseActionClick11Title=单次%@
kmMouseActionClick12Title=双次%@
kmMouseActionClick13Title=三次%@
kmMouseActionClickButton0=点击
kmMouseActionClickButton1=右键点击
kmMouseActionClickButton2=中键点击
kmMouseActionClickButton3=按钮4点击
kmMouseActionClickButton4=按钮5点击
kmMouseActionClickButton5=按钮6点击
kmMouseActionReleaseButton0=鼠标按钮
kmMouseActionReleaseButton1=右键
kmMouseActionReleaseButton2=中键
kmMouseActionReleaseButton3=按钮4
kmMouseActionReleaseButton4=按钮5
kmMouseActionReleaseButton5=按钮6
kmMouseActionAndDragTitle=并拖动
kmMouseActionAndHoldTitle=并按住
kmMouseActionMoveAndTitle=移动到并%@
kmMouseActionNoMoveAndTitle=%@
kmMouseActionScreenTitle=主屏幕的%@
kmMouseActionWindowTitle=前台窗口的%@
kmMouseActionImageTitle=在发现图像的%@
kmMouseActionImageFullTitle=在%@中发现图像的%%@
kmMouseActionCurrentPositionTitle=当前鼠标位置
kmMouseActionAbsolutePositionTitle=绝对位置
kmMouseActionTopLeftTitle=左上角
kmMouseActionTopRightTitle=右上角
kmMouseActionBottomLeftTitle=左下角
kmMouseActionBottomRightTitle=右下角
kmMouseActionCenterTitle=中央
hkNotificationTitle=通知‘%@’

kUntitledButton=好

kQuitSpecificActionType_QuitFormat=退出%@
kQuitSpecificActionType_QuitRelaunchFormat=退出并重新打开%@
kQuitSpecificActionType_ForceQuitFormat=强制退出%@
kQuitSpecificActionType_ForceQuitRelaunchFormat=强制退出并重新打开%@
kQuitSpecificTargetFrontApplication=前台应用程序

kmHideSpecificAppTitleFormat=隐藏%@
kmShowSpecificAppTitleFormat=显示%@
kmQuitSpecificAppTitleFormat=退出%@

kmOpenFinderSelectionTitleFormat=在%@中打开Finder选择
kOpenFinderSelectionTargetCurrentApplication=前台应用程序

kmMoveMouseTitleFormat=移动鼠标到(%@,%@)从%@
kmClickMouseTitleFormat=点击鼠标在(%@,%@)从%@
kmMoveAndClickMouseTitleFormat=移动并点击鼠标(%@,%@)在%@
SendMIDIMessageNoteLabel=对于笔记
SendMIDIMessageCCLabel=对于控制
SendMIDIMessageVelocityLabel=速度为
SendMIDIMessageValueLabel=值为

hkSelectMenuItemFrontAppName=前台的应用程序

hkSelectMenuItemTitleFormat=选择‘%@’在菜单‘%@’在应用%@中

hkShowMenuItemTitleFormat=显示菜单‘%@’在菜单‘%@’在应用%@中
hkShowMenuBarItemTitleFormat=显示菜单‘%@’在应用%@中

hkSelectMenuItemHTMLTitleFormat=选择菜单项在应用%@中
hkShowMenuItemHTMLTitleFormat=显示菜单在应用%@中

kAddRemoveMenuItemEntryControllerTitle=菜单标题
kAddRemoveMenuItemEntryControllerSubmenu=子菜单
kAddRemoveMenuItemEntryControllerItem=菜单项

iTunesCmd_Untitled=无标题

iTunesCmd_PlayPause_Title=播放/暂停当前曲目
iTunesCmd_Stop_Title=停止当前曲目
iTunesCmd_Rewind_Title=快退当前曲目
iTunesCmd_FastForward_Title=快进当前曲目
iTunesCmd_Pause_Title=暂停当前​​曲目
iTunesCmd_NextTrack_Title=下一曲目
iTunesCmd_BackTrack_Title=上一曲目
iTunesCmd_PlayRandomTrack_Title=播放随机曲目

iTunesCmd_PlayNamedTrack_TitleFormat=播放曲目‘%@’
iTunesCmd_PlayNamedTrack_Title=播放特定曲目
iTunesCmd_PlayNamedPlaylist_TitleFormat=播放播放列表‘%@’
iTunesCmd_PlayNamedPlaylist_Title=播放特定播放列表
iTunesCmd_PlayRandomPlaylistTrack_TitleFormat=从播放列表中播放随机曲目‘%@’
iTunesCmd_PlayRandomPlaylistTrack_Title=从播放列表中播放随机曲目
kmForFinderSelection=对于在Finder中选择的每个路径
kmForFolder=对于文件夹中的每个路径
kmClickAtFoundImage=点击发现的图片

kmWhileTitle=当满足条件时执行动作
kmUntilTitle=执行动作，直到条件满足
kmRepeatTitle=重复动作
kmRepeatTitleFormat=重复动作%@次
kmGroupTitle=组合动作
kmIfThenElseTitle=如果%@就执行动作
kmIfThenElseNoConditionsTitle=如果没有条件，什么也不做
AboutRegisteredTo=The Shark破解|墨问非名汉化20160629
kmSimulateKeystrokePressAndReleaseTitleFormat=键入%@按键
kmSimulateKeystrokePressAndHoldTitleFormat=长按%@按键
kmSimulateKeystrokePressAndRepeatTitleFormat=重复按%@按键
kmSimulateKeystrokeReleaseTitleFormat=松开%@按键

kmSimulateModifiersPressAndReleaseTitleFormat=键入%@修饰键%@
kmSimulateModifiersPressAndHoldTitleFormat=长按%@修饰键%@
kmSimulateModifiersPressAndRepeatTitleFormat=重复按%@修饰键%@
kmSimulateModifiersReleaseTitleFormat=松开%@修饰键%@
kmSimulateModifiersNoModifiers=无
cConditionListAnyTitle=满足任何条件
cConditionListAllTitle=满足所有条件
cConditionListNoneTitle=不满足任何条件
cConditionListNotAllTitle=未满足所有条件

cApplicationTitle=应用程序条件
cApplication_LongDescription=应用程序‘%@’%@

cApplication_RunningDescription=运行中
cApplication_NotRunningDescription=未运行
cApplication_ActiveDescription=在前台
cApplication_NotActiveDescription=不在前台
cApplication_RunningButNotActiveDescription=运行中，但不在前台

cFrontWindowTitle=前台窗口条件
ALSwitchMenu=激活
ALSwitchAndHideOthersMenu=激活并隐藏其他
hkProgramSwitcher=激活应用程序切换器
hkSMApplicationSwitcher=激活应用程序切换器
hkWindowSwitcher=激活窗口切换器
hkApplicationLauncher=激活应用程序启动器
hkClipboardSwitcherCopy=激活剪贴板复制切换器
hkClipboardSwitcherCut=激活剪贴板剪切切换器
hkClipboardSwitcherPaste=激活剪贴板粘贴切换器
hkClipboardHistorySwitcher=激活剪贴板历史记录切换器
kmActivateApplicationTitleFormat=激活%@
kSetMacroEnableEnableTitleFormat=启用%@
kSetMacroEnableDisableTitleFormat=禁用%@
kSetMacroEnableToggleTitleFormat=切换%@启用
kSetMacroEnableNoMacro=未知

kmMacroUnknownUnambiguousName=宏/宏组无
kmMacroUnambiguousName=宏‘%@’
kmMacroGroupUnambiguousName=宏组‘%@’
kmMacroSmartGroupUnambiguousName=智能组‘%@’

kmApplyTextFactoryTitleFormat=应用文本工厂‘%@’

kmFileRevealOperation=显示
kmFileMoveOperation=移动或重命名
kmFileCopyOperation=拷贝
kmFileDuplicateOperation=复制
kmFileTrashOperation=移到废纸篓
kmFileDeleteOperation=删除
kmFileRecursiveDeleteOperation=递归删除

kmFileTitleFormat=%@文件
kmFileTitleLongFormat=%@文件‘%@’
iTunesCmd_IncreaseVolume_Title=增加iTunes音量10％
iTunesCmd_IncreaseVolume_ShortTitle=增加iTunes音量
iTunesCmd_DecreaseVolume_Title=减少iTunes音量10％
iTunesCmd_DecreaseVolume_ShortTitle=减少iTunes音量
iTunesCmd_SetVolume_TitleFormat=设置iTunes音量到%d%%
iTunesCmd_SetVolume_Title=设置iTunes音量

iTunesCmd_IncreaseRating_Title=评级增加半个星
iTunesCmd_DecreaseRating_Title=评级减少半个星
iTunesCmd_SetRating_TitleFormat=设置评级为
iTunesCmd_SetRating_Title=设置评级

QuickTimePlayerCmd_Play_Title=播放当前电影
QuickTimePlayerCmd_PlayPause_Title=播放/暂停当前电影
QuickTimePlayerCmd_Pause_Title=暂停当前​​电影
kSafariCommandNewWindowShort=新建%@窗口
kSafariCommandNewWindowLong=新建%@窗口URL‘%@’
kSafariCommandNewTabShort=新建%@标签
kSafariCommandNewTabLong=新建%@标签URL‘%@’
kSafariCommandNextTab=下一个%@标签
kSafariCommandPreviousTab=上一个%@标签
kSafariCommandSelectTabShort=选择%@标签
kSafariCommandSelectTabLong=选择%@标签‘%@’
kSafariCommandSetTitleShort=设置%@标题
kSafariCommandSetTitleLong=设置%@标题为‘%@’
kSafariCommandClickLinkShort=点击链接%@
kSafariCommandClickLinkLong=点击链接%@‘%@’
kSafariCommandSubmitFormShort=提交表单%@
kSafariCommandSubmitFormLong=提交表单%@‘%@’
kSafariCommandResetFormShort=重置%@表单
kSafariCommandResetFormLong=重置%@表单为
kSafariCommandFocusFieldShort=聚焦%@域
kSafariCommandFocusFieldLong=聚焦%@域‘%@’
kSafariCommandSelectFieldShort=选择%@域
kSafariCommandSelectFieldLong=选择%@域‘%@’
kSafariCommandWaitForCompleteShort=等待%@完成加载
kSafariCommandWaitForCompleteLong=等待%@完成加载
kSafariCommandSetDocumentURLShort=设置%@网址
kSafariCommandSetDocumentURLLong=设置%@网址为‘%@’
aScrollWheel_ActionDescFormatUp=模拟滚轮向上%@
aScrollWheel_ActionDescFormatDown=模拟滚轮向下%@
aScrollWheel_ActionDescFormatLeft=模拟滚轮向左%@
aScrollWheel_ActionDescFormatRight=模拟滚轮向右%@
aInsertText_InsertTextTyping=通过键入插入文本
aInsertText_InsertTextPasting=通过粘贴插入文本
aInsertText_DisplayText=显示文本

aInsertText_ByTyping=通过键入插入文本‘%@’
aInsertText_ByPasting=通过粘贴插入文本‘%@’
aInsertText_ByPastingStyles=通过粘贴插入带样式文本‘%@’
aInsertText_DisplayWindow=在窗口中显示文本‘%@’
aInsertText_DisplayBriefly=短暂显示文本‘%@’
aInsertText_DisplayLarge=大尺寸显示文本‘%@’

aInsertTextHTML_ByTyping=通过键入插入文本
aInsertTextHTML_ByPasting=通过粘贴插入文本
aInsertTextHTML_ByPastingStyles=通过粘贴插入带样式文本
aInsertTextHTML_DisplayWindow=在窗口中显示文本
aInsertTextHTML_DisplayBriefly=短暂显示文字
aInsertTextHTML_DisplayLarge=大尺寸显示文字
tTimeTrigger_Monday=星期一
tTimeTrigger_Tuesday=星期二
tTimeTrigger_Wednesday=星期三
tTimeTrigger_Thursday=星期四
tTimeTrigger_Friday=星期五
tTimeTrigger_Saturday=星期六
tTimeTrigger_Sunday=星期日
SendDiagnosticSendReport =发送报告
SendDiagnosticSendReports =发送报告

TimeSavedFormat=节省时间：%@

TimeSavedTimeFormat_None=还没有
TimeSavedTimeFormat_Little=还不多
TimeSavedTimeFormat_Seconds=%ld秒
TimeSavedTimeFormat_Minutes=%ld分钟
TimeSavedTimeFormat_Hours=%ld小时
TimeSavedTimeFormat_Days=%ld天
TimeSavedTimeFormat_Months=%ld月
TimeSavedTimeFormat_Years=%ld年

TimeSavedForSwitcherMaestro=不要浪费时间四处寻找您的应用程序。
cEnvironmentVariableTitle=环境变量条件

cEnvironmentVariable_LongDescription_Exists=环境变量‘%@’存在
cEnvironmentVariable_LongDescription_DoesNotExist=环境变量‘%@’不存在
cEnvironmentVariable_LongDescription_IsEmpty=环境变量‘%@’是空的
cEnvironmentVariable_LongDescription_IsNotEmpty=环境变量‘%@’不为空
cEnvironmentVariable_LongDescription_Is=环境变量‘%@’是‘%@’
cEnvironmentVariable_LongDescription_IsNot=环境变量‘%@’不是‘%@’
cEnvironmentVariable_LongDescription_Contains=环境变量‘%@’包含‘%@’
cEnvironmentVariable_LongDescription_DoesNotContain=环境变量‘%@’不包含‘%@’
cEnvironmentVariable_LongDescription_Matches=环境变量‘%@’匹配‘%@’
cEnvironmentVariable_LongDescription_DoesNotMatch=环境变量‘%@’不匹配‘%@’

cScreenImageTitle=发现图像条件

cScreenImage_LongDescription_Contains=屏幕包含图像
cScreenImage_LongDescription_ContainsUnique=屏幕包含图像且唯一
cScreenImage_LongDescription_DoesNotContain=屏幕不包含图像
cScreenImage_LongDescription_DoesNotContainUnique=屏幕不唯一包含图像

cPixelTitle=像素条件
tTypeStringExactCase=确切的字符串
tTypeStringIgnoreCase=忽略大小写的字符串
tTypeStringRememberCase=不忽略大小写的字符串
tTypeStringMatch=正则表达式
tCurrentApplicationTriggerLaunchesFormat=任何应用程序启动
tCurrentApplicationTriggerActivatesFormat=任何应用程序激活
tCurrentApplicationTriggerDeactivatesFormat=任何应用程序停用
tCurrentApplicationTriggerQuitsFormat=任何应用程序退出
tCurrentApplicationTriggerWhilteActiveFormat=当任何应用程序活动时，%@
tCurrentApplicationTriggerWhileRunningFormat=当任何应用程序运行时，%@

tApplicationTriggerDescFormatRepeat=每%@重复
tApplicationTriggerLaunchesFormat=应用程序‘%@’启动
tApplicationTriggerActivatesFormat=应用程序‘%@’激活
tApplicationTriggerDeactivatesFormat=应用程序‘%@’停用
tApplicationTriggerQuitsFormat=应用程序‘%@’退出
tApplicationTriggerWhilteActiveFormat=当应用程序‘%@’活动时，%@
tApplicationTriggerWhileRunningFormat=当应用程序‘%@’运行时，%@